BEST	B EH S T
BIRTHDAY	B ER TH D EY
CAPTURE	K AE P CH ER
DATE	D EY T
DID	D IH D
DOWN	D AW N
HELLO	HH AH L OW
HELLO(2)	HH EH L OW
HEY	HH EY
HOW	HH AW
IS	IH Z
LILY	L IH L IY
MICROPHONE	M AY K R AH F OW N
OKEY	OW K IY
OUTPUT	AW T P UH T
PI	P AY
PLAYBACK	P L EY B AE K
PROGRAM	P R OW G R AE M
RASPBERRY	R AE Z B EH R IY
SISTER	S IH S T ER
STOP	S T AA P
THE	DH AH
THE(2)	DH IY
TIME	T AY M
UP	AH P
VOLUME	V AA L Y UW M
WEATHER	W EH DH ER
WHAT	W AH T
WHAT(2)	HH W AH T
WHO	HH UW
YOU	Y UW
